1111111111
10000CPE11
1111111111