11111111
1000CPE1
10000001
11111111
