111111111111111111
100111110000111111
10001P1CCCE0111111
100001000000111111
100C00000000111111

111111111111111111
